00 10 20 30 40 50 60 70
01 11 21 31 41 51 61 71
02 12 22 32 42 52 62 72
03 13 23 33 43 53 63 73
04 14 24 34 44 54 64 74
05 15 25 35 45 55 65 75